create table
FTA_REPLICATION.HARVESTING_AUTHORITY
(
HVA_SKEY	NUMERIC(22,10)
,FOREST_FILE_ID	VARCHAR(10)
,CUTTING_PERMIT_ID	VARCHAR(3)
,HARVESTING_AUTHORITY_ID	VARCHAR(30)
,FOREST_DISTRICT	NUMERIC(22,10)
,DISTRICT_ADMN_ZONE	VARCHAR(4)
,GEOGRAPHIC_DISTRICT	NUMERIC(22,10)
,MGMT_UNIT_ID	VARCHAR(4)
,MGMT_UNIT_TYPE_CODE	VARCHAR(1)
,LICENCE_TO_CUT_CODE	VARCHAR(2)
,HARVEST_TYPE_CODE	VARCHAR(1)
,HARVEST_AUTH_STATUS_CODE	VARCHAR(3)
,TENURE_TERM	NUMERIC(22,5)
,STATUS_DATE	DATE
,ISSUE_DATE	DATE
,EXPIRY_DATE	DATE
,EXTEND_DATE	DATE
,EXTEND_COUNT	NUMERIC(22,10)
,HARVEST_AUTH_EXTEND_REAS_CODE	VARCHAR(1)
,QUOTA_TYPE_CODE	VARCHAR(1)
,CROWN_LANDS_REGION_CODE	VARCHAR(1)
,SALVAGE_TYPE_CODE	VARCHAR(3)
,CASCADE_SPLIT_CODE	VARCHAR(1)
,CATASTROPHIC_IND	VARCHAR(1)
,CROWN_GRANTED_IND	VARCHAR(1)
,CRUISE_BASED_IND	VARCHAR(1)
,DECIDUOUS_IND	VARCHAR(1)
,BCAA_FOLIO_NUMBER	VARCHAR(23)
,LOCATION	VARCHAR(100)
,HIGHER_LEVEL_PLAN_REFERENCE	VARCHAR(30)
,HARVEST_AREA	NUMERIC(22,11)
,RETIREMENT_DATE	DATE
,REVISION_COUNT	NUMERIC(22,5)
,ENTRY_USERID	VARCHAR(30)
,ENTRY_TIMESTAMP	DATE
,UPDATE_USERID	VARCHAR(30)
,UPDATE_TIMESTAMP	DATE
,IS_WASTE_ASSESSMENT_REQUIRED	VARCHAR(1)
,IS_CP_EXTENSN_APPL_FEE_WAIVED	VARCHAR(1)
,IS_CP_EXTENSION_APPL_FEE_PAID	VARCHAR(1)
,IS_WITHIN_FIBRE_RECOVERY_ZONE	VARCHAR(1)
,HARVESTING_AUTHORITY_GUID	BYTEA
);

ALTER TABLE  
FTA_REPLICATION.HARVESTING_AUTHORITY
ADD CONSTRAINT 
HVA_PK
PRIMARY KEY 
(HVA_SKEY);